DVM
An Interactive Fiction by spanky
Release 1 / Serial number 140721 / Inform 7 build 6L02 (I6/v6.33 lib 6/12N) SD

Public Bathroom
I'm in a public bathroom, lit by a single buzzing fluorescent light. A sink juts out of the wall, the hot water knob missing. A dusty sign above it reads, "Employees must wash hands before returning to work." A toilet sits in the corner. There's no toilet paper.

I can see a bathroom door and a loose ceiling tile here.

>turn on sink
It isn't something I can switch.

>stand on toilet
You are now standing on the toilet.

>take ceiling tile
Taken.

>look
Public Bathroom (on the toilet)
I'm in a public bathroom, lit by a single buzzing fluorescent light. A sink juts out of the wall, the hot water knob missing. A dusty sign above it reads, "Employees must wash hands before returning to work." A toilet sits in the corner. There's no toilet paper.

I can see a hole in the ceiling (in which is a duffel bag (closed)) here.

>take all
hole in the ceiling: Taken.
duffel bag: Taken.

* * *

DVM
An Interactive Fiction by spanky
Release 1 / Serial number 140721 / Inform 7 build 6L02 (I6/v6.33 lib 6/12N) SD

Public Bathroom
I'm in a public bathroom, lit by a single buzzing fluorescent light. A sink juts out of the wall, the hot water knob missing. A dusty sign above it reads, "Employees must wash hands before returning to work." A toilet sits in the corner. There's no toilet paper.

I can see a bathroom door and a loose ceiling tile here.

>w
(first opening the bathroom door)

Vacant Office Space
The huge empty office space's beige drywall and concrete floor are dimly lit by a few emergency lights. Without desks, chairs, or cubicle walls, the place almost looks like a warehouse, albeit one with a decent view of the city. The previous tenant was some kind of telecom, I think, judging by some old hardware and paperwork left behind from their move. I like to use this space since it's not likely to get leased in a hurry, what with the recession.

I can see a small cluster of cubicles to the west.

From here I can take the elevator down to the lobby.

I can see a bathroom door here.

>d
Office Lobby
The lobby is rather spartan, but not as neglected as the space upstairs. An empty desk for a receptionist sits here, as does a building directory.

I can see through the glass doors in front to 58th Street outside.

I can see a pencil here.

>down
I can't go that way.

* * *

>d
Office Lobby
The lobby is rather spartan, but not as neglected as the space upstairs. An empty desk for a receptionist sits here, as does a building directory.

I can see through the glass doors in front to 58th Street outside.

I can see a pencil here.

>u
Vacant Office Space
The huge empty office space's beige drywall and concrete floor are dimly lit by a few emergency lights. Without desks, chairs, or cubicle walls, the place almost looks like a warehouse, albeit one with a decent view of the city. The previous tenant was some kind of telecom, I think, judging by some old hardware and paperwork left behind from their move. I like to use this space since it's not likely to get leased in a hurry, what with the recession.

I can see a small cluster of cubicles to the west.

From here I can take the elevator down to the lobby.

I can see a bathroom door here.

* * *

>d
Office Lobby
The lobby is rather spartan, but not as neglected as the space upstairs. An empty desk for a receptionist sits here, as does a building directory.

I can see through the glass doors in front to 58th Street outside.

I can see a pencil here.

>out
You are already standing.

>out
You are already standing.

>go outside
W 58th St. and Avenue of the Americas

>w
I can't go that way.

>n
W 59th St. and Avenue of the Americas

>w
W 59th St. and 7th Ave.

* * *

>go outside
W 58th St. and Avenue of the Americas

>s
Olympia Coffee

>buy coffee
I'll need some money to pay for it.

>i
I am carrying nothing.

>n
W 58th St. and Avenue of the Americas

>n
W 59th St. and Avenue of the Americas

>e
Outside the Everett-Fitzgerald Hotel

>n
I can't go that way.

>n
I can't go that way.

>e
I can't go that way.

* * *

>down
Office Lobby
The lobby is rather spartan, but not as neglected as the space upstairs. An empty desk for a receptionist sits here, as does a building directory.

I can see through the glass doors in front to 58th Street outside.

I can see a pencil here.

>w
I can't go that way.

>go outisde
I can't see any such thing.

>go outside
W 58th St. and Avenue of the Americas

* * *

>n
W 59th St. and Avenue of the Americas

>s
W 58th St. and Avenue of the Americas

>n
W 59th St. and Avenue of the Americas

* * *

>w
W 59th St. and 7th Ave.

>e
W 59th St. and Avenue of the Americas

>s
W 58th St. and Avenue of the Americas

>e
I can't go that way.

>w
I can't go that way.

* * *

>w
W 59th St. and 7th Ave.

>s
W 58th St. and 7th Ave.

>e
Empire Athletic Club
I can see a manager here.

>w
W 58th St. and 7th Ave.

>s
Midtown Animal Hospital

* * *

DVM
An Interactive Fiction by spanky
Release 1 / Serial number 140721 / Inform 7 build 6L02 (I6/v6.33 lib 6/12N) SD

Public Bathroom
I'm in a public bathroom, lit by a single buzzing fluorescent light. A sink juts out of the wall, the hot water knob missing. A dusty sign above it reads, "Employees must wash hands before returning to work." A toilet sits in the corner. There's no toilet paper.

I can see a bathroom door and a loose ceiling tile here.

>s
I can't go that way.

Woo

>look
Public Bathroom
I'm in a public bathroom, lit by a single buzzing fluorescent light. A sink juts out of the wall, the hot water knob missing. A dusty sign above it reads, "Employees must wash hands before returning to work." A toilet sits in the corner. There's no toilet paper.

I can see a bathroom door and a loose ceiling tile here.

Woo

>w
(first opening the bathroom door)

Vacant Office Space
The huge empty office space's beige drywall and concrete floor are dimly lit by a few emergency lights. Without desks, chairs, or cubicle walls, the place almost looks like a warehouse, albeit one with a decent view of the city. The previous tenant was some kind of telecom, I think, judging by some old hardware and paperwork left behind from their move. I like to use this space since it's not likely to get leased in a hurry, what with the recession.

I can see a small cluster of cubicles to the west.

From here I can take the elevator down to the lobby.

I can see a bathroom door here.

Woo

>down
Office Lobby
The lobby is rather spartan, but not as neglected as the space upstairs. An empty desk for a receptionist sits here, as does a building directory.

I can see through the glass doors in front to 58th Street outside.

I can see a pencil here.

Woo

>go outside
W 58th St. and Avenue of the Americas
Woo

>go inside
Office Lobby
The lobby is rather spartan, but not as neglected as the space upstairs. An empty desk for a receptionist sits here, as does a building directory.

I can see through the glass doors in front to 58th Street outside.

I can see a pencil here.

Woo

>go outside
W 58th St. and Avenue of the Americas
Woo

>n
W 59th St. and Avenue of the Americas
Woo

>e
Outside the Everett-Fitzgerald Hotel
Woo

>e
I can't go that way.

Woo

>w
W 59th St. and Avenue of the Americas
Woo

>e
Outside the Everett-Fitzgerald Hotel
Woo

>w
W 59th St. and Avenue of the Americas
Woo

>s
W 58th St. and Avenue of the Americas
Woo

>s
Olympia Coffee
Woo

>n
W 58th St. and Avenue of the Americas
Woo

>n
W 59th St. and Avenue of the Americas
Woo

* * *

>e
I can't go that way.

Woo

>n
I can't go that way.

Woo

>w
W 59th St. and Avenue of the Americas
Woo

>w
W 59th St. and 7th Ave.
Woo

>s
Empire Athletic Club
I can see a manager here.

Woo

>s
I can't go that way.

Woo

* * *

DVM
An Interactive Fiction by spanky
Release 1 / Serial number 140721 / Inform 7 build 6L02 (I6/v6.33 lib 6/12N) SD

Public Bathroom
I'm in a public bathroom, lit by a single buzzing fluorescent light. A sink juts out of the wall, the hot water knob missing. A dusty sign above it reads, "Employees must wash hands before returning to work." A toilet sits in the corner. There's no toilet paper.

I can see a bathroom door and a loose ceiling tile here.

>stand on toilet
You are now standing on the toilet.

>take
What do you want to take?

>take all
loose ceiling tile: Taken.

>take all
You'll have to be more specific.

>look
Public Bathroom (on the toilet)
I'm in a public bathroom, lit by a single buzzing fluorescent light. A sink juts out of the wall, the hot water knob missing. A dusty sign above it reads, "Employees must wash hands before returning to work." A toilet sits in the corner. There's no toilet paper.

I can see a hole in the ceiling (in which is a duffel bag (closed)) and a bathroom door here.

>open bag
I open the duffel bag, revealing a stack of cash.

>d
(first getting off the toilet)
I can't go that way.

>w
(first opening the bathroom door)

Vacant Office Space
The huge empty office space's beige drywall and concrete floor are dimly lit by a few emergency lights. Without desks, chairs, or cubicle walls, the place almost looks like a warehouse, albeit one with a decent view of the city. The previous tenant was some kind of telecom, I think, judging by some old hardware and paperwork left behind from their move. I like to use this space since it's not likely to get leased in a hurry, what with the recession.

I can see a small cluster of cubicles to the west.

From here I can take the elevator down to the lobby.

I can see a bathroom door here.

>w
Empty Cubicles
The west side of the floor is taken up by the half-broken remnants of a cubicle farm. The empty maze of gray panels resembles a broken hive, long since abandoned by its worker drones. Whatever company moved out of here appears to have been in a hurry; assorted desks and supplies still remain in some of the cubicles, and papers litter the floor.

I can see a paper clip and a filing cabinet (closed) here.

>take all
You'll have to be more specific.

>e
Vacant Office Space
The huge empty office space's beige drywall and concrete floor are dimly lit by a few emergency lights. Without desks, chairs, or cubicle walls, the place almost looks like a warehouse, albeit one with a decent view of the city. The previous tenant was some kind of telecom, I think, judging by some old hardware and paperwork left behind from their move. I like to use this space since it's not likely to get leased in a hurry, what with the recession.

I can see a small cluster of cubicles to the west.

From here I can take the elevator down to the lobby.

I can see a bathroom door here.

>down
Office Lobby
The lobby is rather spartan, but not as neglected as the space upstairs. An empty desk for a receptionist sits here, as does a building directory.

I can see through the glass doors in front to 58th Street outside.

I can see a pencil here.

>take all
There are none at all available!

* * *

>stand on toilet
You are now standing on the toilet.

>take tile
Taken.

>take bag
Taken.

>open bag
I open the duffel bag, revealing a rifle and a stack of cash.

>take cash
Taken.

>d
(first getting off the toilet)
I can't go that way.

* * *

>down
Office Lobby
The lobby is rather spartan, but not as neglected as the space upstairs. An empty desk for a receptionist sits here, as does a building directory.

I can see through the glass doors in front to 58th Street outside.

I can see a pencil here.

>out
You are already standing.

* * *

>s
Olympia Coffee

>s
I can't go that way.

* * *

>n
W 58th St. and Avenue of the Americas

>e
I can't go that way.

>n
W 59th St. and Avenue of the Americas

* * *

>e
Outside the Everett-Fitzgerald Hotel

>s
Everett-Fitzgerald Hotel Lobby
I can see a concierge here.

>e
Conference Room
I can see a ticket here.

>take ticket
Taken.

>w
Everett-Fitzgerald Hotel Lobby
I can see a concierge here.

* * *

>i
I am carrying:
  a gym bag (closed)
  a dozen coffees
  a stack of cash
  a duffel bag (open)
    a rifle
  a loose ceiling tile

>open gym bag
I open the gym bag, revealing workout clothes and a pass.

>take pass
Taken.

>n
Outside the Everett-Fitzgerald Hotel

>w
W 59th St. and Avenue of the Americas

>w
W 59th St. and 7th Ave.

>s
Empire Athletic Club
I can see a manager here.

* * *

>e
Locker Room
I can see a lockers (closed) here.

>open lockers
I open the lockers, revealing an envelope.

>take envelop
I can't see any such thing.

>take envelope
Taken.

>i
I am carrying:
  an envelope (closed)
  a gym bag (open)
    workout clothes
  a dozen coffees
  a stack of cash
  a duffel bag (open)
    a rifle
  a loose ceiling tile

>open envelope
I open the envelope, revealing a hotel key.

>n
I can't go that way.

>w
Empire Athletic Club
I can see a manager here.

>n
W 59th St. and 7th Ave.

>w
Columbus Circle

>w
Outside the Macau Grand Hotel

>w
I can't go that way.

>n
Macau Grand Hotel Lobby

I beg your pardon?

>u
I'll need the key to a room before I can use the elevator.

>i
I am carrying:
  an envelope (open)
    a hotel key
  a gym bag (open)
    workout clothes
  a dozen coffees
  a stack of cash
  a duffel bag (open)
    a rifle
  a loose ceiling tile

>take out key
I only understood you as far as wanting to take outside.

>take key
Taken.

>u
Hallway

>e
Presidential Suite

* * *

>shoot rifle
I'll have to aim it first.

* * *

>stand on toilet
You are now standing on the toilet.

>take all
You'll have to be more specific.

>down
(first getting off the toilet)
I can't go that way.

>w
(first opening the bathroom door)

Vacant Office Space
The huge empty office space's beige drywall and concrete floor are dimly lit by a few emergency lights. Without desks, chairs, or cubicle walls, the place almost looks like a warehouse, albeit one with a decent view of the city. The previous tenant was some kind of telecom, I think, judging by some old hardware and paperwork left behind from their move. I like to use this space since it's not likely to get leased in a hurry, what with the recession.

I can see a small cluster of cubicles to the west.

From here I can take the elevator down to the lobby.

I can see a bathroom door here.

>w
Empty Cubicles
The west side of the floor is taken up by the half-broken remnants of a cubicle farm. The empty maze of gray panels resembles a broken hive, long since abandoned by its worker drones. Whatever company moved out of here appears to have been in a hurry; assorted desks and supplies still remain in some of the cubicles, and papers litter the floor.

I can see a filing cabinet (closed) here.

>down
I can't go that way.

>i
I am carrying:
  a loose ceiling tile

* * *

>take all
You'll have to be more specific.

>take all
duffel bag: Taken.

>open bag
I open the duffel bag, revealing a stack of cash.

>s
(first getting off the toilet)
I can't go that way.

>w
(first opening the bathroom door)

Vacant Office Space
The huge empty office space's beige drywall and concrete floor are dimly lit by a few emergency lights. Without desks, chairs, or cubicle walls, the place almost looks like a warehouse, albeit one with a decent view of the city. The previous tenant was some kind of telecom, I think, judging by some old hardware and paperwork left behind from their move. I like to use this space since it's not likely to get leased in a hurry, what with the recession.

I can see a small cluster of cubicles to the west.

From here I can take the elevator down to the lobby.

I can see a bathroom door here.

* * *

>d
Office Lobby
The lobby is rather spartan, but not as neglected as the space upstairs. An empty desk for a receptionist sits here, as does a building directory.

I can see through the glass doors in front to 58th Street outside.

I can see a pencil here.

>n
I can't go that way.

>s
I can't go that way.

* * *

>w
I can't go that way.

>out
You are already standing.

* * *

>s
Olympia Coffee

>buy coffee
I'll have to take the money out to pay for anything.

>i
I am carrying:
  a duffel bag (open)
    a stack of cash
  a loose ceiling tile

>drop tile
Dropped.

>take out cash
I only understood you as far as wanting to take outside.

>i
I am carrying:
  a duffel bag (open)
    a stack of cash

>take cash
Taken.

* * *

>i
I am carrying:
  a dozen coffees
  a stack of cash
  a duffel bag (open but empty)

>n
W 58th St. and Avenue of the Americas

* * *

>e
Conference Room
I can see a ticket here.

>i
I am carrying:
  a dozen coffees
  a stack of cash
  a duffel bag (open but empty)

>drop coffee
I can't see any such thing.

>drop coffees
Dropped.

>w
Everett-Fitzgerald Hotel Lobby
I can see a concierge here.

>e
Conference Room
I can see a dozen coffees and a ticket here.

>take coffees
Taken.

>w
Everett-Fitzgerald Hotel Lobby
I can see a concierge here.

>w
I can't go that way.

>n
Outside the Everett-Fitzgerald Hotel

>s
Everett-Fitzgerald Hotel Lobby
I can see a concierge here.

>drop coffees
Dropped.

* * *

>look
Everett-Fitzgerald Hotel Lobby
I can see a dozen coffees and a concierge here.

* * *

>get coffees
Taken.

>e
Conference Room
I can see a ticket here.

* * *

>w
Everett-Fitzgerald Hotel Lobby
I can see a concierge here.

>i
I am carrying:
  a ticket
  a dozen coffees
  a stack of cash
  a duffel bag (open but empty)

* * *

>i
I am carrying:
  a gym bag (closed)
  a dozen coffees
  a stack of cash
  a duffel bag (open but empty)

>open gym bag
I open the gym bag, revealing workout clothes.

>take workout clothes
Taken.

>put on workout clothes
I put on workout clothes.

>wear workout clothes
I'm already wearing that!

* * *

>w
Empty Cubicles
The west side of the floor is taken up by the half-broken remnants of a cubicle farm. The empty maze of gray panels resembles a broken hive, long since abandoned by its worker drones. Whatever company moved out of here appears to have been in a hurry; assorted desks and supplies still remain in some of the cubicles, and papers litter the floor.

I can see a paper clip and a filing cabinet (closed) here.

>take all
paper clip: Taken.
stack of cash: Taken.

>e
Vacant Office Space
The huge empty office space's beige drywall and concrete floor are dimly lit by a few emergency lights. Without desks, chairs, or cubicle walls, the place almost looks like a warehouse, albeit one with a decent view of the city. The previous tenant was some kind of telecom, I think, judging by some old hardware and paperwork left behind from their move. I like to use this space since it's not likely to get leased in a hurry, what with the recession.

I can see a small cluster of cubicles to the west.

From here I can take the elevator down to the lobby.

I can see a bathroom door here.

>d
Office Lobby
The lobby is rather spartan, but not as neglected as the space upstairs. An empty desk for a receptionist sits here, as does a building directory.

I can see through the glass doors in front to 58th Street outside.

I can see a pencil here.

>take all
pencil: Taken.

>out
You are already standing.

* * *

>go outside
W 58th St. and Avenue of the Americas

>n
W 59th St. and Avenue of the Americas

* * *

>s
Everett-Fitzgerald Hotel Lobby
I can see a concierge here.

>n
Outside the Everett-Fitzgerald Hotel

* * *

>w
W 59th St. and Avenue of the Americas

>s
W 58th St. and Avenue of the Americas

>s
Olympia Coffee

* * *

>i
I am carrying:
  a dozen coffees
  a pencil
  a stack of cash
  a paper clip
  a duffel bag (open but empty)
  a loose ceiling tile

>n
W 58th St. and Avenue of the Americas

* * *

>e
Outside the Everett-Fitzgerald Hotel

>e
I can't go that way.

>s
Everett-Fitzgerald Hotel Lobby
I can see a concierge here.

* * *

>take ticket
Taken.

>i
I am carrying:
  a ticket
  a dozen coffees
  a pencil
  a stack of cash
  a paper clip
  a duffel bag (open but empty)
  a loose ceiling tile

>w
Everett-Fitzgerald Hotel Lobby
I can see a concierge here.

* * *

>i
I am carrying:
  a gym bag (closed)
  a dozen coffees
  a pencil
  a stack of cash
  a paper clip
  a duffel bag (open but empty)
  a loose ceiling tile

>open gym bag
I open the gym bag, revealing workout clothes and a pass.

>n
Outside the Everett-Fitzgerald Hotel

* * *

>w
W 59th St. and 7th Ave.

>w
I can't go that way.

>s
Empire Athletic Club
I can see a manager here.

>i
I am carrying:
  a gym bag (open)
    workout clothes
    a pass
  a dozen coffees
  a pencil
  a stack of cash
  a paper clip
  a duffel bag (open but empty)
  a loose ceiling tile

>take pass
Taken.

* * *

>i
I am carrying:
  a gym bag (open)
    workout clothes
  a dozen coffees
  a pencil
  a stack of cash
  a paper clip
  a duffel bag (open but empty)
  a loose ceiling tile

>look
Empire Athletic Club
I can see a manager here.

>w
Gym

>e
Empire Athletic Club
I can see a manager here.

>e
Locker Room

* * *

>take all
duffel bag: Taken.

>exit
I get off the toilet.

Public Bathroom
I'm in a public bathroom, lit by a single buzzing fluorescent light. A sink juts out of the wall, the hot water knob missing. A dusty sign above it reads, "Employees must wash hands before returning to work." A toilet sits in the corner. There's no toilet paper.

I can see a hole in the ceiling (empty) and a bathroom door here.

>w
(first opening the bathroom door)

Vacant Office Space
The huge empty office space's beige drywall and concrete floor are dimly lit by a few emergency lights. Without desks, chairs, or cubicle walls, the place almost looks like a warehouse, albeit one with a decent view of the city. The previous tenant was some kind of telecom, I think, judging by some old hardware and paperwork left behind from their move. I like to use this space since it's not likely to get leased in a hurry, what with the recession.

I can see a small cluster of cubicles to the west.

From here I can take the elevator down to the lobby.

I can see a bathroom door here.

* * *

>w
Empty Cubicles
The west side of the floor is taken up by the half-broken remnants of a cubicle farm. The empty maze of gray panels resembles a broken hive, long since abandoned by its worker drones. Whatever company moved out of here appears to have been in a hurry; assorted desks and supplies still remain in some of the cubicles, and papers litter the floor.

I can see a paper clip and a filing cabinet (closed) here.

>take all
paper clip: Taken.

>e
Vacant Office Space
The huge empty office space's beige drywall and concrete floor are dimly lit by a few emergency lights. Without desks, chairs, or cubicle walls, the place almost looks like a warehouse, albeit one with a decent view of the city. The previous tenant was some kind of telecom, I think, judging by some old hardware and paperwork left behind from their move. I like to use this space since it's not likely to get leased in a hurry, what with the recession.

I can see a small cluster of cubicles to the west.

From here I can take the elevator down to the lobby.

I can see a bathroom door here.

* * *

>down
Office Lobby
The lobby is rather spartan, but not as neglected as the space upstairs. An empty desk for a receptionist sits here, as does a building directory.

I can see through the glass doors in front to 58th Street outside.

I can see a pencil here.

>e
I can't go that way.

* * *

>w
I can't go that way.

>look
Office Lobby
The lobby is rather spartan, but not as neglected as the space upstairs. An empty desk for a receptionist sits here, as does a building directory.

I can see through the glass doors in front to 58th Street outside.

I can see a pencil here.

>e
I can't go that way.

>look
Office Lobby
The lobby is rather spartan, but not as neglected as the space upstairs. An empty desk for a receptionist sits here, as does a building directory.

I can see through the glass doors in front to 58th Street outside.

I can see a pencil here.

* * *

>w
I can't go that way.

>go outside
W 58th St. and Avenue of the Americas

* * *

>e
Outside the Everett-Fitzgerald Hotel

>go inside
I can't go that way.

>s
Everett-Fitzgerald Hotel Lobby
I can see a concierge here.

>look concierge
I see nothing special about the concierge.

* * *

>look
Everett-Fitzgerald Hotel Lobby
I can see a concierge here.

>w
I can't go that way.

* * *

>out
You are already standing.

>n
Outside the Everett-Fitzgerald Hotel

* * *

>buy coffee
I'll have to take the money out to pay for anything.

>i
I am carrying:
  a paper clip
  a duffel bag (closed)
  a loose ceiling tile

>open bag
I open the duffel bag, revealing a stack of cash.

>take money
Taken.

>take cash
I already have that.

>i
I am carrying:
  a stack of cash
  a paper clip
  a duffel bag (open but empty)
  a loose ceiling tile

* * *

>i
I am carrying:
  a dozen coffees
  a stack of cash
  a paper clip
  a duffel bag (open but empty)
  a loose ceiling tile

>u
I can't go that way.

>n
W 58th St. and Avenue of the Americas

* * *

>n
W 59th St. and Avenue of the Americas

>n
I can't go that way.

>e
Outside the Everett-Fitzgerald Hotel

* * *

>i
I am carrying:
  a gym bag (closed)
  a dozen coffees
  a stack of cash
  a paper clip
  a duffel bag (open but empty)
  a loose ceiling tile

>open gym bag
I open the gym bag, revealing workout clothes and a pass.

* * *

>w
W 59th St. and Avenue of the Americas

>w
I can't go that way.

* * *

>take all
You'll have to be more specific.

>look
Public Bathroom (on the toilet)
I'm in a public bathroom, lit by a single buzzing fluorescent light. A sink juts out of the wall, the hot water knob missing. A dusty sign above it reads, "Employees must wash hands before returning to work." A toilet sits in the corner. There's no toilet paper.

I can see a bathroom door and a loose ceiling tile here.

>take tile
Taken.

>look
Public Bathroom (on the toilet)
I'm in a public bathroom, lit by a single buzzing fluorescent light. A sink juts out of the wall, the hot water knob missing. A dusty sign above it reads, "Employees must wash hands before returning to work." A toilet sits in the corner. There's no toilet paper.

I can see a hole in the ceiling (in which is a duffel bag (closed)) and a bathroom door here.

>take bag
Taken.

>open bag
I open the duffel bag, revealing a stack of cash.

>take cash
Taken.

>down
(first getting off the toilet)
I can't go that way.

* * *

>d
Office Lobby
The lobby is rather spartan, but not as neglected as the space upstairs. An empty desk for a receptionist sits here, as does a building directory.

I can see through the glass doors in front to 58th Street outside.

I can see a pencil here.

>take pencil
Taken.

>go out
W 58th St. and Avenue of the Americas

>n
W 59th St. and Avenue of the Americas

* * *

>s
I can't go that way.

>look
Olympia Coffee

* * *

>i
I am carrying:
  a dozen coffees
  a pencil
  a stack of cash
  a duffel bag (open but empty)
  a loose ceiling tile

>n
W 58th St. and Avenue of the Americas

* * *

>w
Everett-Fitzgerald Hotel Lobby
I can see a concierge here.

>n
Outside the Everett-Fitzgerald Hotel

* * *

>look
Empire Athletic Club
I can see a manager here.

>give pass to manager
I can't see any such thing.

>look
Empire Athletic Club
I can see a manager here.

* * *

>give pass to manager
I can't see any such thing.

>give pass to the manager
I can't see any such thing.

>show pass to manager
I can't see any such thing.

>look
Empire Athletic Club
I can see a manager here.

>give pass
I can't see any such thing.

>show pass
I can't see any such thing.

>i
I am carrying:
  a ticket
  a dozen coffees
  a pencil
  a stack of cash
  a duffel bag (open but empty)
  a loose ceiling tile

>n
W 59th St. and 7th Ave.

>e
W 59th St. and Avenue of the Americas

>e
Outside the Everett-Fitzgerald Hotel

* * *

>s
Everett-Fitzgerald Hotel Lobby
I can see a concierge here.

>i
I am carrying:
  a ticket
  a dozen coffees
  a pencil
  a stack of cash
  a duffel bag (open but empty)
  a loose ceiling tile

>show ticket to concierg
I can't see any such thing.

* * *

>i
I am carrying:
  a gym bag (closed)
  a dozen coffees
  a pencil
  a stack of cash
  a duffel bag (open but empty)
  a loose ceiling tile

>open gym bag
I open the gym bag, revealing workout clothes and a pass.

* * *

>s
I can't go that way.

>e
I can't go that way.

>n
W 58th St. and Avenue of the Americas

* * *

>w
I can't go that way.

I beg your pardon?

>look
W 58th St. and Avenue of the Americas

>w
I can't go that way.

* * *

>i
I am carrying:
  a gym bag (open)
    workout clothes
  a dozen coffees
  a pencil
  a stack of cash
  a duffel bag (open but empty)
  a loose ceiling tile

>e
Locker Room

>look
Locker Room

>w
Empire Athletic Club
I can see a manager here.

>w
Gym

* * *

>e
Locker Room

>open locker
I can't see any such thing.

* * *

>stand on toilet
You are now standing on the toilet.

>look
Public Bathroom (on the toilet)
I'm in a public bathroom, lit by a single buzzing fluorescent light. A sink juts out of the wall, the hot water knob missing. A dusty sign above it reads, "Employees must wash hands before returning to work." A toilet sits in the corner. There's no toilet paper.

I can see a bathroom door and a loose ceiling tile here.

>take all
loose ceiling tile: Taken.

>look
Public Bathroom (on the toilet)
I'm in a public bathroom, lit by a single buzzing fluorescent light. A sink juts out of the wall, the hot water knob missing. A dusty sign above it reads, "Employees must wash hands before returning to work." A toilet sits in the corner. There's no toilet paper.

I can see a hole in the ceiling (in which is a duffel bag (closed)) and a bathroom door here.

>take all
duffel bag: Taken.

>i
I am carrying:
  a duffel bag (closed)
  a loose ceiling tile

>open duffel bag
I open the duffel bag, revealing a stack of cash.

>look
Public Bathroom (on the toilet)
I'm in a public bathroom, lit by a single buzzing fluorescent light. A sink juts out of the wall, the hot water knob missing. A dusty sign above it reads, "Employees must wash hands before returning to work." A toilet sits in the corner. There's no toilet paper.

I can see a hole in the ceiling (empty) and a bathroom door here.

>look
Public Bathroom (on the toilet)
I'm in a public bathroom, lit by a single buzzing fluorescent light. A sink juts out of the wall, the hot water knob missing. A dusty sign above it reads, "Employees must wash hands before returning to work." A toilet sits in the corner. There's no toilet paper.

I can see a hole in the ceiling (empty) and a bathroom door here.

>i
I am carrying:
  a duffel bag (open)
    a stack of cash
  a loose ceiling tile

>x stack
A banded stack of twenties, totaling $2,000, weighing just under 0.23 pounds. It's all I have left in loose cash, the rest is already spent, so to speak.

>look
Public Bathroom (on the toilet)
I'm in a public bathroom, lit by a single buzzing fluorescent light. A sink juts out of the wall, the hot water knob missing. A dusty sign above it reads, "Employees must wash hands before returning to work." A toilet sits in the corner. There's no toilet paper.

I can see a hole in the ceiling (empty) and a bathroom door here.

>w
(first getting off the toilet)
(first opening the bathroom door)

Vacant Office Space
The huge empty office space's beige drywall and concrete floor are dimly lit by a few emergency lights. Without desks, chairs, or cubicle walls, the place almost looks like a warehouse, albeit one with a decent view of the city. The previous tenant was some kind of telecom, I think, judging by some old hardware and paperwork left behind from their move. I like to use this space since it's not likely to get leased in a hurry, what with the recession.

I can see a small cluster of cubicles to the west.

From here I can take the elevator down to the lobby.

I can see a bathroom door here.

>w
Empty Cubicles
The west side of the floor is taken up by the half-broken remnants of a cubicle farm. The empty maze of gray panels resembles a broken hive, long since abandoned by its worker drones. Whatever company moved out of here appears to have been in a hurry; assorted desks and supplies still remain in some of the cubicles, and papers litter the floor.

I can see a paper clip and a filing cabinet (closed) here.

>open filing cabinet
It's locked. There's no hope of finding the key since the original owner is long gone. I'll need to find some other way to get it open.

>take
What do you want to take?

>take all
paper clip: Taken.
stack of cash: Taken.

>look
Empty Cubicles
The west side of the floor is taken up by the half-broken remnants of a cubicle farm. The empty maze of gray panels resembles a broken hive, long since abandoned by its worker drones. Whatever company moved out of here appears to have been in a hurry; assorted desks and supplies still remain in some of the cubicles, and papers litter the floor.

I can see a filing cabinet (closed) here.

>i
I am carrying:
  a stack of cash
  a paper clip
  a duffel bag (open but empty)
  a loose ceiling tile

>i stack
I only understood you as far as wanting to take inventory.

>x stack
A banded stack of twenties, totaling $2,000, weighing just under 0.23 pounds. It's all I have left in loose cash, the rest is already spent, so to speak.

>x paper clip
I see nothing special about the paper clip.

* * *

>take ceiling tile
Taken.

>look
Public Bathroom (on the toilet)
I'm in a public bathroom, lit by a single buzzing fluorescent light. A sink juts out of the wall, the hot water knob missing. A dusty sign above it reads, "Employees must wash hands before returning to work." A toilet sits in the corner. There's no toilet paper.

I can see a hole in the ceiling (in which is a duffel bag (closed)) and a bathroom door here.

* * *

>take bag
Taken.

>down
(first getting off the toilet)
I can't go that way.

* * *

>take pencil
Taken.

>n
I can't go that way.

>out
You are already standing.

* * *

>e
I can't go that way.

>w
W 59th St. and Avenue of the Americas

* * *

>s
I can't go that way.

>buy coffee
I'll have to take the money out to pay for anything.

>i
I am carrying:
  a pencil
  a duffel bag (closed)
  a loose ceiling tile

>open bag
I open the duffel bag, revealing a stack of cash.

* * *

>i
I am carrying:
  a gym bag (closed)
  a dozen coffees
  a stack of cash
  a pencil
  a duffel bag (open but empty)
  a loose ceiling tile

>open bag
Which do you mean, the gym bag or the duffel bag?

>open gym bag
I open the gym bag, revealing workout clothes and a pass.

* * *

>w
W 59th St. and 7th Ave.

>w
Columbus Circle

>s
I can't go that way.

>e
W 59th St. and 7th Ave.

>s
Empire Athletic Club
I can see a manager here.

>i
I am carrying:
  a pass
  a gym bag (open)
    workout clothes
  a dozen coffees
  a stack of cash
  a pencil
  a duffel bag (open but empty)
  a loose ceiling tile

* * *

>open lockers
I open the lockers, revealing an envelope.

>take envelope
Taken.

>open envelope
I open the envelope, revealing a hotel key.

>take key
Taken.

>n
I can't go that way.

* * *

>w
Empire Athletic Club
I can see a manager here.

>e
Locker Room
I can see a lockers (empty) here.

>w
Empire Athletic Club
I can see a manager here.

* * *

>e
Outside the Everett-Fitzgerald Hotel

>w
W 59th St. and Avenue of the Americas

* * *

>n
Macau Grand Hotel Lobby

>look
Macau Grand Hotel Lobby

>up
Hallway